AA	IUPAC	DNA
Ala	GCN	GCT/GCC/GCA/GCG
Arg	CGN/AGR	CGT/CGC/CGA/CGG/AGA/AGG
Asn	AAY	AAT/AAC
Asp	GAY	GAT/GAC
Cys	TGY	TGT/TGC
Gln	CAR	CAA/CAG
Glu	GAR	GAA/GAG
Gly	GGN	GGT/GGC/GGA/GGG
His	CAY	CAT/CAC
Ile	ATH	ATT/ATC/ATA
START		ATG
Leu	YTR/CTN	TTA/TTG/CTT/CTC/CTA/CTG
Lys	AAR	AAA/AAG
Met		ATG
Phe	TTY	TTT/TTC
Pro	CCN	CCT/CCC/CCA/CCG
Ser	TCN/AGY	TCT/TCC/TCA/TCG/AGT/AGC
Thr	ACN	ACT/ACC/ACA/ACG
Trp		TGG
Tyr	TAY	TAT/TAC
Val	GTN	GTT/GTC/GTA/GTG
STOP	TRA/TAG	TAA/TGA/TAG
